1111111111111
10010000000C1
1000011111001
1P0011E000001
1000110001001
10C1100C01001
1111111111111
